NO ./source/colorstone.xpm
SO ./source/new2.xpm
WE ./source/new3.xpm
EA ./source/new4.xpm

F 220,100,0
C 225,30,0

111111111111111111111111111111111111111
100000000000000000000001000000000000001
100000000000000000N00000000000000000001
100000000000000000000000000000000000001
111111111111111111111111111111111111111